contradictory	/ˌkɑntɹəˈdɪktəɹi/	ˌkɑntrəˈdiktəri
nefarious	/nɛˈfɛəɹi.əs/	neˈfeəriəs
getting	/ˈɡɛɾɪŋ/	ˈgetiŋ
ability	/əˈ.bɪl.ɪ.ti/	əˈbiliti
absolute	/ˈæb.səˌljuːt/	ˈæbsəˌlju:t
academic	/ˌækəˈdɛmɪk/	ˌækəˈdemik
accident	/ˈæk.sə.dənt/	ˈæksədənt
activity	/ækˈtɪ.və.ti/	ækˈtivəti
agreement	/əˈɡɹiːmənt/	əˈgri:mənt
ambition	/æmˈbɪ.ʃən/	æmˈbiʃən
analysis	/əˈnælɪsɪs/	əˈnælisis
apartment	/əˈpɑːt.mənt/	əˈpɑ:tmənt
application	/aplɪˈkeɪʃ(ə)n/	apliˈkeiʃən
attention	/əˈtɛn.ʃən/	əˈtenʃən
attitude	/ˈætɪˌtjuːd/	ˈætiˌtju:d
audience	/ˈɔːdi.əns/	ˈɔ:diəns
available	/əˈveɪləb(ə)l/	əˈveiləbəl
balance	/ˈbæləns/	ˈbæləns
beautiful	/ˈbjuːtɪfəl/	ˈbju:tifəl
benefit	/ˈbɛn.ɪ.fɪt/	ˈbenifit
biology	/baɪˈɒlədʒɪ/	baiˈɔləʤi
business	/ˈbɪd.nəs/	ˈbidnəs
camera	/ˈkæməɹə/	ˈkæmərə
capacity	/kəˈpæsɪti/	kəˈpæsiti
category	/ˈkætəˌɡɔɹi/	ˈkætəˌgɔri
celebrate	/ˈsɛl.ə.bɹeɪt/	ˈseləbreit
challenge	/ˈtʃæl.əndʒ/	ˈʧælənʤ
chemical	/ˈkɛmɪkəl/	ˈkemikəl
comfortable	/ˈkʌm.fə.tə.bəl/	ˈkʌmfətəbəl
community	/k(ə)ˈmjunəti/	kəˈmjunəti
company	/ˈkʌmp(ə)ni/	ˈkʌmpəni
competition	/ˌkɒmpəˈtɪʃən/	ˌkɔmpəˈtiʃən
complaint	/kəmˈpleɪnt/	kəmˈpleint
completely	/kəmˈpliːtli/	kəmˈpli:tli
conclusion	/kənˈkluːʒən/	kənˈklu:ʒən
condition	/kənˈdɪʃən/	kənˈdiʃən
conference	/ˈkɒn.fə.ɹəns/	ˈkɔnfərəns
confident	/ˈkɒn.fɪ.dənt/	ˈkɔnfidənt
conflict	/kənˈflɪkt/	kənˈflikt
connection	/kəˈnɛkʃən/	kəˈnekʃən
consequence	/ˈkɒnsɪkwɛns/	ˈkɔnsikwens
consider	/kənˈsɪdə/	kənˈsidə
consumer	/kənˈsjuːmə/	kənˈsju:mə
continue	/kənˈtɪnjuː/	kənˈtinju:
convenient	/kənˈviːniənt/	kənˈvi:niənt
courageous	/kəˈɹeɪdʒəs/	kəˈreiʤəs
creative	/kɹiˈeɪtɪv/	kriˈeitiv
criminal	/ˈkɹɪmənəl/	ˈkrimənəl
criticism	/ˈkɹɪtɪsɪzəm/	ˈkritisizəm
dangerous	/ˈdeɪnd͡ʒ(ə)ɹəs/	ˈdeinʤərəs
decision	/dɪˈsɪʒən/	diˈsiʒən
delicious	/dɪˈlɪʃəs/	diˈliʃəs
democracy	/dɪˈmɒkɹəsi/	diˈmɔkrəsi
department	/dɪˈpɑːtm(ə)nt/	diˈpɑ:tmənt
dependable	/dɪˈpɛndəbəɫ/	diˈpendəbəl
description	/dɪˈskɹɪpʃən/	diˈskripʃən
develop	/dɛˈvɛ.ləp/	deˈveləp
difference	/ˈdɪfəɹən(t)s/	ˈdifərənts
difficulty	/ˈdɪfɪkəlti/	ˈdifikəlti
direction	/d(a)ɪˈɹɛk.ʃən/	daiˈrekʃən
discovery	/dɪsˈkʌvəɹi/	disˈkʌvəri
discussion	/dɪsˈkʊʃən/	disˈkuʃən
education	/ˌɛdjʊˈkeɪʃn̩/	ˌedjuˈkeiʃən
electricity	/ɪˌlɛkˈtɹɪsɪti/	iˌlekˈtrisiti
emotion	/iˈmoʊʃən/	iˈmouʃən
encourage	/ɪnˈkʌɹɪdʒ/	inˈkʌriʤ
especially	/əˈspɛʃ(ə)li/	əˈspeʃəli
essential	/ɪˈsɛn.ʃəl/	iˈsenʃəl
establish	/ɪˈstæb.lɪʃ/	iˈstæbliʃ
experience	/ɪkˈspɪə.ɹɪəns/	ikˈspiəriəns
explanation	/ˌɛkspləˈneɪʃən/	ˌekspləˈneiʃən
familiar	/fəˈmɪl.i.ə/	fəˈmiliə
fantastic	/fænˈtæstɪk/	fænˈtæstik
financial	/faɪˈnænʃəl/	faiˈnænʃəl
flexible	/ˈflɛk.sə.bəl/	ˈfleksəbəl
following	/ˈfɒləʊɪŋ/	ˈfɔləuiŋ
fortunate	/ˈfɔːt͡ʃənət/	ˈfɔ:ʧənət
frequently	/ˈfɹiː.kwənt.li/	ˈfri:kwəntli
friendly	/ˈfɹɛndli/	ˈfrendli
function	/ˈfʌŋ(k)ʃən/	ˈfʌŋkʃən
furniture	/ˈfɜːnɪtʃə/	ˈfə:niʧə
generation	/ˌd͡ʒɛnəˈɹeɪʃən/	ˌʤenəˈreiʃən
government	/ˈɡʌvə(n)mənt/	ˈgʌvənmənt
happiness	/ˈhæpinəs/	ˈhæpinəs
historical	/hɪˈstɒɹɪkəl/	hiˈstɔrikəl
honesty	/ˈɒnəsti/	ˈɔnəsti
hospital	/ˈhɒs.pɪ.tl̩/	ˈhɔspitəl
important	/ɪmˈpɔːtənt/	imˈpɔ:tənt
impression	/ɪmˈpɹɛʃən/	imˈpreʃən
independent	/ɪndɪˈpɛndənt/	indiˈpendənt
individual	/ˌɘndɘˈvɘd͡ʒɘl/	ˌindiˈvidjuəl
information	/ˌɪnfəˈmeɪʃən/	ˌinfəˈmeiʃən
ingredient	/ɪnˈɡɹiːdi.ənt/	inˈgri:diənt
initiative	/ɪˈnɪʃətɪv/	iˈniʃətiv
intelligent	/ɪnˈtɛlɪd͡ʒənt/	inˈteliʤənt
intention	/ɪnˈtɛnʃən/	inˈtenʃən
interested	/ˈɪntəɹɛstəd/	ˈintərestəd
invisible	/ɪnˈvɪzəb(ə)l/	inˈvizəbəl
invitation	/ɪn.vɪˈteɪ.ʃn̩/	inviˈteiʃən
knowledge	/ˈnɒlɪdʒ/	ˈnɔliʤ
language	/ˈleɪŋɡwɪd͡ʒ/	ˈleiŋgwiʤ
leadership	/ˈliːdəʃɪp/	ˈli:dəʃip
literature	/ˈlɪ.tə.ɹɪ.tʃə(ɹ)/	ˈlitəriʧər
measure	/ˈmɛʒə/	ˈmeʒə
pleasure	/ˈplɛʒə/	ˈpleʒə
breathe	/briːð/	bri:ð
mother	/ˈmʌðə/	ˈmʌðə
this	/ðɪs/	ðis
think	/θɪŋk/	θiŋk
author	/ˈɔːθə/	ˈɔ:θə
care	/keə/	keə
hair	/heə/	heə
pure	/pjʊə/	pjuə
tourist	/ˈtʊərɪst/	ˈtuərist
judge	/ʤʌʤ/	ʤʌʤ
major	/ˈmeɪʤə/	ˈmeiʤə
sing	/sɪŋ/	siŋ
running	/ˈrʌnɪŋ/	ˈrʌniŋ
